S S SS S X   S      
         X  S S  S S
  S S    X  S       
  S   S  X  S S  S  
    S    X          
  S  S   XXXXXXXXXXX
 S    S      S  X   
         SS    XX   
XXXXXXXXXXXXXXXXX  S
  S   XS  X S     S
      X   X
    S XXX XXX S   S
   S  S X   X
        XXXXXSS  S
   SS     X     S   
  SSSS    W  S S    
 SSSSSS        S    
  SSS S    SS    S  
 S      S S    S SS 
     S  S   S S S  S
