SS             SS  S
  S S S  S S  S     
     XXXXX  S  SS S
XXXXXX X X        S
  S X  XXXXS      S
  SXXX   X  XXXXX
  S X  X XXX   X  S
    S SX X  X  XX S
       X W  XXXXXXXS
   S   XXX        SS
     S S        S S
 S   S    SS    S S 
  SSS    S   S      
 S   S          SS  
 S S S  S  S  SS SS 
 S   S         S SS 
 SSSSS     S   S  S 
 SS SS  S      SSSS 
      S    S   S  SS
             S      
